11111111
1P000001
1C011101
1001E101
11111111
