111111
1P0001
100001
1C0E01
110011
