1111111111
1P0000C001
1000000001
1C0000E001
1111111111